111111111111111
1E0000P00000001
1100000C0000001
100001111110001
100000000000001
100000000000001
100000000000001
111111111111111
