1111111111111111111111111
1P000000000000000000000E1
1000011110111000001111001
1C0000000000000000C000001
1110000000011000000000001
1100000000001100000000001
1000000000000111000000001
1001100000000000000000001
100C100000011111000000001
1111111111111111111111111
